011015015001
021015012502
031015013503
041015013304
051015012005
061015014506