0110150150
0110150125
0210150135
0210150133
0210150120
0310150145